UFAM-I-5	INFORMATICA
UFC-CC-5	CIENCIAS DA COMPUTACAO
UNIFOR-IA-4	INFORMATICA APLICADA
UFRN-SC-5	SISTEMAS E COMPUTACAO
UFCG-CC-4	CIENCIA DA COMPUTACAO
UFPE-CC-7	CIENCIAS DA COMPUTACAO
UFES-I-4	INFORMATICA
UFRJ-ESC-7	ENGENHARIA DE SISTEMAS E COMPUTACAO
UFRJ-I-4	INFORMATICA
UFF-C-6	COMPUTACAO
PUC-RIO-I-7	INFORMATICA
IME-SC-3	SISTEMAS E COMPUTACAO
UFMG-CC-7	CIENCIAS DA COMPUTACAO
UFV-CC-4	CIENCIA DA COMPUTACAO
UFU-CC-4	CIENCIA DA COMPUTACAO
UFSCAR-CC-4	CIENCIA DA COMPUTACAO
USP-CC-6	CIENCIA DA COMPUTACAO
USP-SC-CCMC-7	CIENCIAS DA COMPUTACAO E MATEMATICA COMPUTACIONAL
UNICAMP-CC-7	CIENCIA DA COMPUTACAO
UFPR-I-5	INFORMATICA
PUC-PR-I-5	Informatica
UEM-CC-4	CIENCIA DA COMPUTACAO
UFSC-CC-5	CIENCIAS DA COMPUTACAO
UFRGS-C-7	COMPUTACAO
PUC-RS-CC-6	CIENCIA DA COMPUTACAO
UNISINOS-CA-4	COMPUTACAO APLICADA
UFMS-CC-4	CIENCIA DA COMPUTACAO
UFG-CC-4	CIENCIA DA COMPUTACAO
UNB-I-5	INFORMATICA
PUC-MG-I-4	INFORMATICA
UFPA-CCD-4	CIENCIA DA COMPUTACAO
UFPE-CC-4	CIENCIAS DA COMPUTACAO
UNESP-SJRP-CA-4	CIENCIA DA COMPUTACAO
UFPB-JP-I-4	INFORMATICA
UNIFACS-SC-3	SISTEMAS E COMPUTACAO
UECE-CA-2	COMPUTACAO APLICADA
UPE-EC-4	ENGENHARIA DA COMPUTACAO
CESAR-ES-4	ENGENHARIA DE SOFTWARE
UNIRIO-DI-4	INFORMATICA
UECE-CC-4	CIENCIA DA COMPUTACAO
UFBA-CC-4	CIENCIA DA COMPUTACAO
UFSM-CC-3	Ciencia da Computacao
UNIVALI-CA-3	COMPUTACAO
UEL-CC-3	CIENCIA DA COMPUTACAO
UERN-UFERSA-CC-3	CIENCIA DA COMPUTACAO - UERN - UFERSA
UNIFEI-CTC-3	CIENCIA E TECNOLOGIA DA COMPUTACAO
UFOP-CC-4	Ciencia da Computacao
UTFPR-CA-3	Computacao Aplicada
UFMS-CCU-4	CIENCIA DA COMPUTACAO - UFMS - UFG
FUFSE-CC-3	Ciencia da Computacao
USP-SI-4	Sistemas de Informacao
UEMA-ECS-3	Engenharia de  Computacao e Sistemas
UFABC-CC-4	Ciencia da Computacao
UFJF-CC-3	Ciencia da Computacao
UFMA-CC-3	Ciencia da Computacao
UFPEL-C-4	Computacao
UFRPE-IA-3	Informatica Aplicada
UNIFACCAMP-CC-3	Ciencia da Computacao
UNIFESP-CC-4	Ciencia da Computacao
UDESC-CA-3	Computacao Aplicada
FUFPI-CC-3	Ciencia da Computacao
UFLA-CC-3	Ciencia da Computacao
FURG-EC-3	Computacao
UFAL-I-3	Informatica
UFBA-CC-3	CIENCIA DA COMPUTACAO
UFSCAR-CC-3	Ciencia da Computacao
UNB-MPCA-3	Computacao Aplicada
UTFPR-I-3	Informatica
UFMS-CA-3	Computacao Aplicada
UFRN-ES-3	Tecnologia da Informacao
FUPF-CA-3	Computacao Aplicada
UFBA-CC-4	Ciencia da Computacao
IFCE-CC-3	Ciencia da Computacao
USP-RP-CA-3	COMPUTACAO APLICADA
UTFPR-CC-3	CIENCIA DA COMPUTACAO
CEFET-RJ-CC-3	CIENCIA DA COMPUTACAO
UFPA-CA-3	COMPUTACAO APLICADA
